8   8  8  8  8  8  8  8  8  8  8  8  8  8  8  8  8      8  8  8  8  8  8  8  8  8  8  8  8  8  8  8  8      8  8  10  10  10  10  10  10  10  10  10  10  10  10  10  10    8
8   8  8  8  8  8  8  8  8  8  8  8  8  8  8  8  8      8  8  8  8  8  8  8  8  8  8  8  8  8  8  8  8      8  8  10   0  10   0  10   0   0  10   0  10   0  10   0  10    8
8   8  8  8  8  8  8  8  8  8  8  8  8  8  8  8  8      8  8  8  8  8  8  8  8  8  8  8  8  8  8  8  8      8  8  10   0  10   0  10   0   0  10   0  10   0  10   0  10    8
8   0  0  0  0  0  0  0  0  0  0  0  0  0  0  7  8      8  9  0  0  0  0  0  0  0  7  9  0  0  0  7  8      8  9   0   0   0   0   0   0   0   0   0   0   0   0   0  10    8
8   0  0  0  5  5  5  5  0  0  0  0  0  0  0  0  7      9  0  0  6  0  6  0  0  0  0  0  0  6  0  0  7      9  0   0   0  10   0   0   0   0  10   0   0   0  10   0  10    8
8   0  0  0  0  0  0  0  0  5  5  5  0  0  0  0  11      11  0  0  0  0  0  0  0  0  0  0  0  0  0  0  11      11  0  10   0   0   0   0   0   0   0   0   0   0   0   0   0    8
8   0  0  0  5  5  5  5  0  0  0  0  0  0  0  0  11      11  0  0  6  0  6  0  0  0  0  0  0  6  0  0  11      11  0   0   0  10   0  10   0   0  10   0  10   0  10   0   0    8
8   0  0  0  0  0  0  0  0  5  5  5  0  0  0  0  11      11  0  0  0  0  0  0  0  0  0  0  0  0  0  0  11      11  0  10   0   0   0   0   0   0   0   0   0   0   0   0   0    8
8   0  0  0  5  5  5  5  0  0  0  0  0  0  0  0  2      4  0  0  6  0  6  0  0  0  0  0  0  6  0  0  2      4  0   0   0  10   0   0   0   0  10   0   0   0  10   0  10    8
8   0  0  0  0  0  0  0  0  0  0  0  0  0  0  2  8      8  4  0  0  0  0  0  0  0  2  4  0  0  0  2  8      8  4   0   0   0   0   0   0   0   0   0   0   0   0   0  10    8
8   3  3  3  3  3  3  3  3  3  3  3  3  11  11  8  8      8  8  3  3  3  3  3  0  0  8  8  3  3  3  8  8      8  8  10   0  10   0  10   0   0  10   0  10   0  10   0  10    8
8   8  8  8  8  8  8  8  8  8  8  8  8  11  11  8  8      8  8  8  8  8  8  8  11  11  8  8  8  8  8  8  8      8  8  10   11  10   11  10   11   11  10   11  10   11  10   11  10    8

8   8  8  8  8  8  8  8  8  8  8  8  8  11  11  8  8      8  8  8  8  8  8  8  11  11  8  8  8  8  8  8  8      8  8  10   11  10   11  10   11   11  10   11  10  11  10   11  10    8
8   8  8  8  8  8  8  8  8  8  8  8  9  11  11  8  8      8  8  8  8  12  8  9  0  0  8  8  8  8  8  8  8      8  8  10   0  10   0  10   0   0  10   0  10   0  10   0  10    8
8   0  0  0  0  0  0  0  0  0  0  0  0  0  0  8  8      8  8  8  9  0  0  0  0  0  8  8  8  8  8  8  8      8  8   0   0   0   0   0   0   0   0   0   0   0   0   0   0    8
8   0  0  0  0  0  0  0  0  6  0  0  0  0  0  7  8      8  8  9  0  0  0  0  0  0  8  8  8  8  8  8  8      8  9   0   0   0   0  10   0   0  10   0  10   0  10   0   0    8
8   0  0  0  0  0  0  0  0  0  0  6  0  0  0  11  7      8  9  0  0  0  0  0  0  0  7  8  8  8  8  8  8      9  0  10   0  10   0   0   0   0   0   0   0   0   0   0   0    8
8   0  0  6  0  0  6  0  0  6  0  0  0  0  0  11  11      11  11  0  0  0  0  0  0  0  0  0  0  0  0  11  11     11  11   0   0   0   0  10   0   0  10   0  10   0  10   0   0    8
8   0  0  0  0  0  0  0  0  0  0  6  0  0  0  11  2      3  4  0  0  0  0  0  0  0  0  0  0  0  0  3  3      4  0  10   0  10   0   0   0   0   0   0   0   0   0   0   0    8
8   0  0  0  0  0  0  0  0  6  0  0  0  0  0  2  8      8  8  0  0  0  0  0  0  0  0  0  0  0  0  8  8      8  4   0   0   0   0  10   0   0  10   0  10   0  10   0   0    8
8   0  0  0  0  0  0  0  0  0  0  0  0  0  0  8  8      8  8  0  0  0  0  0  0  0  0  0  0  0  0  8  8      8  8   0   0   0   0   0   0   0   0   0   0   0   0   0   0    8
8   3  3  3  3  3  3  3  3  3  3  3  3  3  3  8  8      8  8  3  3  3  3  3  3  3  3  3  3  3  3  8  8      8  8  10  10  10  10  10  10  10  10  10  10  10  10  10  10    8
8   8  8  8  8  8  8  8  8  8  8  8  8  8  8  8  8      8  8  8  8  8  8  8  8  8  8  8  8  8  8  8  8      8  8  10  10  10  10  10  10  10  10  10  10  10  10  10  10    8
8   8  8  8  8  8  8  8  8  8  8  8  8  8  8  8  8      8  8  8  8  8  8  8  8  8  8  8  8  8  8  8  8      8  8  10  10  10  10  10  10  10  10  10  10  10  10  10  10    8

